########
#......#
#......#
#@.....#
#......#
#......#
#......#
########