###############
#.............#
#.............#
#.............#
#.............#
#.............#
#..............
#......@.......
#..............
#.............#
#.............#
#.............#
#.............#
#.............#
###############