########
#......#
#.####.#
#.#..#.#
#.#..#.#
#.####.#
#......#
########