###############
#.............#
#.............#
#.............#
#.............#
#.............#
#.............#
#......$......#
#.............#
#.............#
#.............#
#.............#
#.............#
#.............#
###############