###############
#.............#
#.............#
#..#########..#
#..#########..#
#..#########..#
#..#########..#
#..#########..#
#..#########..#
#..#########..#
#..#########..#
#..#########..#
#.............#
#.............#
###############