###############
#.............#
#.............#
#..##.....##..#
#..##.....##..#
#.............#
#.............#
#.............#
#.............#
#.............#
#..##.....##..#
#..##.....##..#
#.............#
#.............#
###############