###############
#...#.....#...#
#.............#
#.............#
#...#.....#...#
######..#######
#.............#
#.............#
#.............#
######..#######
#...#.....#...#
#.............#
#.............#
#...#.....#...#
###############