###############
#.............#
#.............#
#.............#
######...######
#.............#
#.............#
#.............#
#.............#
#.............#
######...######
#.............#
#.............#
#.............#
###############