###############
#.............#
#.............#
#..###...###..#
#..#.......#..#
#..#.......#..#
#.............#
#.............#
#.............#
#..#.......#..#
#..#.......#..#
#..###...###..#
#.............#
#.............#
###############