###############
#.............#
#.............#
#..##..#..##..#
#..##..#..##..#
#......#......#
#......#......#
#..#########..#
#......#......#
#......#......#
#..##..#..##..#
#..##..#..##..#
#.............#
#.............#
###############