###############
#.............#
#.............#
#.............#
#...#######...#
#.............#
#.............#
#...#######...#
#.............#
#.............#
#...#######...#
#.............#
#.............#
#.............#
###############