###############
#...#.........#
#...#.........#
#...#.........#
#...#.....#...#
#...#.....#...#
#...#.....#...#
#...#.....#...#
#...#.....#...#
#...#.....#...#
#...#.....#...#
#.........#...#
#.........#...#
#.........#...#
###############