###############
#.............#
#.............#
#.....###.....#
#.....###.....#
#.....###.....#
#..#########..#
#..#########..#
#..#########..#
#.....###.....#
#.....###.....#
#.....###.....#
#.............#
#.............#
###############