###############
#...#.....#...#
#.............#
#.............#
#...#.....#...#
######...######
#.............#
#.............#
#.............#
######...######
#...#.....#...#
#.............#
#.............#
#...#.....#...#
###############