###############
#.............#
#.............#
#.............#
#.............#
#.............#
#.............#
#......@......#
#.............#
#.............#
#.............#
#.............#
#.............#
#.............#
###############